"filename", "language", "C++", "C", "comment", "blank", "total"
"d:\RECENT\技术\sylar\sylar\address.cc", "C++", 469, 0, 7, 83, 559
"d:\RECENT\技术\sylar\sylar\address.h", "C++", 117, 0, 168, 45, 330
"d:\RECENT\技术\sylar\sylar\application.cc", "C++", 301, 0, 13, 43, 357
"d:\RECENT\技术\sylar\sylar\application.h", "C++", 30, 0, 1, 11, 42
"d:\RECENT\技术\sylar\sylar\bytearray.cc", "C++", 564, 0, 0, 90, 654
"d:\RECENT\技术\sylar\sylar\bytearray.h", "C++", 91, 0, 331, 65, 487
"d:\RECENT\技术\sylar\sylar\config.cc", "C++", 87, 0, 4, 16, 107
"d:\RECENT\技术\sylar\sylar\config.h", "C++", 348, 0, 169, 49, 566
"d:\RECENT\技术\sylar\sylar\daemon.cc", "C++", 75, 0, 2, 8, 85
"d:\RECENT\技术\sylar\sylar\daemon.h", "C++", 20, 0, 13, 9, 42
"d:\RECENT\技术\sylar\sylar\db\db.h", "C++", 91, 0, 0, 17, 108
"d:\RECENT\技术\sylar\sylar\db\fox_thread.cc", "C++", 426, 0, 15, 62, 503
"d:\RECENT\技术\sylar\sylar\db\fox_thread.h", "C++", 130, 0, 2, 34, 166
"d:\RECENT\技术\sylar\sylar\db\mysql.cc", "C++", 1046, 0, 26, 176, 1248
"d:\RECENT\技术\sylar\sylar\db\mysql.h", "C++", 332, 0, 28, 66, 426
"d:\RECENT\技术\sylar\sylar\db\redis.cc", "C++", 1034, 0, 176, 118, 1328
"d:\RECENT\技术\sylar\sylar\db\redis.h", "C++", 258, 0, 12, 50, 320
"d:\RECENT\技术\sylar\sylar\db\sqlite3.cc", "C++", 567, 0, 0, 114, 681
"d:\RECENT\技术\sylar\sylar\db\sqlite3.h", "C++", 268, 0, 23, 47, 338
"d:\RECENT\技术\sylar\sylar\ds\array.h", "C++", 213, 0, 0, 35, 248
"d:\RECENT\技术\sylar\sylar\ds\bitmap.cc", "C++", 806, 0, 38, 68, 912
"d:\RECENT\技术\sylar\sylar\ds\bitmap.h", "C++", 119, 0, 4, 32, 155
"d:\RECENT\技术\sylar\sylar\ds\cache_status.h", "C++", 62, 0, 0, 12, 74
"d:\RECENT\技术\sylar\sylar\ds\dict.h", "C++", 388, 0, 18, 58, 464
"d:\RECENT\技术\sylar\sylar\ds\hash_map.h", "C++", 269, 0, 13, 47, 329
"d:\RECENT\技术\sylar\sylar\ds\hash_multimap.h", "C++", 478, 0, 7, 71, 556
"d:\RECENT\技术\sylar\sylar\ds\lru_cache.h", "C++", 265, 0, 0, 47, 312
"d:\RECENT\技术\sylar\sylar\ds\roaring.c", "C", 0, 9808, 915, 916, 11639
"d:\RECENT\技术\sylar\sylar\ds\roaring.h", "C++", 4276, 0, 2135, 815, 7226
"d:\RECENT\技术\sylar\sylar\ds\roaring.hh", "C++", 1180, 0, 633, 199, 2012
"d:\RECENT\技术\sylar\sylar\ds\roaring_bitmap.cc", "C++", 154, 0, 2, 36, 192
"d:\RECENT\技术\sylar\sylar\ds\roaring_bitmap.h", "C++", 60, 0, 3, 25, 88
"d:\RECENT\技术\sylar\sylar\ds\timed_cache.h", "C++", 317, 0, 0, 49, 366
"d:\RECENT\技术\sylar\sylar\ds\timed_lru_cache.h", "C++", 327, 0, 0, 49, 376
"d:\RECENT\技术\sylar\sylar\ds\util.cc", "C++", 152, 0, 5, 16, 173
"d:\RECENT\技术\sylar\sylar\ds\util.h", "C++", 214, 0, 0, 42, 256
"d:\RECENT\技术\sylar\sylar\email\email.cc", "C++", 54, 0, 0, 9, 63
"d:\RECENT\技术\sylar\sylar\email\email.h", "C++", 56, 0, 0, 16, 72
"d:\RECENT\技术\sylar\sylar\email\smtp.cc", "C++", 159, 0, 0, 18, 177
"d:\RECENT\技术\sylar\sylar\email\smtp.h", "C++", 36, 0, 0, 10, 46
"d:\RECENT\技术\sylar\sylar\endian.h", "C++", 48, 0, 29, 15, 92
"d:\RECENT\技术\sylar\sylar\env.cc", "C++", 123, 0, 2, 19, 144
"d:\RECENT\技术\sylar\sylar\env.h", "C++", 36, 0, 0, 13, 49
"d:\RECENT\技术\sylar\sylar\fd_manager.cc", "C++", 94, 0, 0, 15, 109
"d:\RECENT\技术\sylar\sylar\fd_manager.h", "C++", 46, 0, 82, 19, 147
"d:\RECENT\技术\sylar\sylar\fiber.cc", "C++", 195, 0, 10, 40, 245
"d:\RECENT\技术\sylar\sylar\fiber.h", "C++", 50, 0, 96, 25, 171
"d:\RECENT\技术\sylar\sylar\hook.cc", "C++", 416, 0, 0, 59, 475
"d:\RECENT\技术\sylar\sylar\hook.h", "C++", 59, 0, 19, 29, 107
"d:\RECENT\技术\sylar\sylar\http\http.cc", "C++", 310, 0, 4, 46, 360
"d:\RECENT\技术\sylar\sylar\http\http.h", "C++", 301, 0, 387, 88, 776
"d:\RECENT\技术\sylar\sylar\http\http11_common.h", "C++", 6, 0, 0, 4, 10
"d:\RECENT\技术\sylar\sylar\http\http11_parser.h", "C++", 32, 0, 8, 9, 49
"d:\RECENT\技术\sylar\sylar\http\http_connection.cc", "C++", 463, 0, 3, 35, 501
"d:\RECENT\技术\sylar\sylar\http\http_connection.h", "C++", 138, 0, 166, 36, 340
"d:\RECENT\技术\sylar\sylar\http\http_parser.cc", "C++", 214, 0, 7, 47, 268
"d:\RECENT\技术\sylar\sylar\http\http_parser.h", "C++", 48, 0, 98, 26, 172
"d:\RECENT\技术\sylar\sylar\http\http_server.cc", "C++", 46, 0, 0, 10, 56
"d:\RECENT\技术\sylar\sylar\http\http_server.h", "C++", 26, 0, 26, 11, 63
"d:\RECENT\技术\sylar\sylar\http\http_session.cc", "C++", 69, 0, 1, 8, 78
"d:\RECENT\技术\sylar\sylar\http\http_session.h", "C++", 16, 0, 27, 10, 53
"d:\RECENT\技术\sylar\sylar\http\httpclient_parser.h", "C++", 31, 0, 33, 11, 75
"d:\RECENT\技术\sylar\sylar\http\servlet.cc", "C++", 141, 0, 0, 26, 167
"d:\RECENT\技术\sylar\sylar\http\servlet.h", "C++", 125, 0, 111, 41, 277
"d:\RECENT\技术\sylar\sylar\http\servlets\config_servlet.cc", "C++", 41, 0, 0, 5, 46
"d:\RECENT\技术\sylar\sylar\http\servlets\config_servlet.h", "C++", 15, 0, 0, 6, 21
"d:\RECENT\技术\sylar\sylar\http\servlets\status_servlet.cc", "C++", 124, 0, 0, 11, 135
"d:\RECENT\技术\sylar\sylar\http\servlets\status_servlet.h", "C++", 15, 0, 0, 6, 21
"d:\RECENT\技术\sylar\sylar\http\session_data.cc", "C++", 54, 0, 0, 10, 64
"d:\RECENT\技术\sylar\sylar\http\session_data.h", "C++", 58, 0, 0, 13, 71
"d:\RECENT\技术\sylar\sylar\http\ws_connection.cc", "C++", 102, 0, 0, 15, 117
"d:\RECENT\技术\sylar\sylar\http\ws_connection.h", "C++", 25, 0, 0, 6, 31
"d:\RECENT\技术\sylar\sylar\http\ws_server.cc", "C++", 46, 0, 0, 6, 52
"d:\RECENT\技术\sylar\sylar\http\ws_server.h", "C++", 23, 0, 0, 8, 31
"d:\RECENT\技术\sylar\sylar\http\ws_servlet.cc", "C++", 54, 0, 0, 11, 65
"d:\RECENT\技术\sylar\sylar\http\ws_servlet.h", "C++", 73, 0, 0, 13, 86
"d:\RECENT\技术\sylar\sylar\http\ws_session.cc", "C++", 238, 0, 0, 28, 266
"d:\RECENT\技术\sylar\sylar\http\ws_session.h", "C++", 62, 0, 7, 14, 83
"d:\RECENT\技术\sylar\sylar\iomanager.cc", "C++", 361, 0, 12, 63, 436
"d:\RECENT\技术\sylar\sylar\iomanager.h", "C++", 55, 0, 93, 20, 168
"d:\RECENT\技术\sylar\sylar\library.cc", "C++", 70, 0, 0, 12, 82
"d:\RECENT\技术\sylar\sylar\library.h", "C++", 11, 0, 0, 6, 17
"d:\RECENT\技术\sylar\sylar\log.cc", "C++", 678, 0, 14, 93, 785
"d:\RECENT\技术\sylar\sylar\log.h", "C++", 196, 0, 343, 84, 623
"d:\RECENT\技术\sylar\sylar\macro.h", "C++", 29, 0, 12, 6, 47
"d:\RECENT\技术\sylar\sylar\main.cc", "C++", 13, 0, 0, 2, 15
"d:\RECENT\技术\sylar\sylar\module.cc", "C++", 204, 0, 0, 39, 243
"d:\RECENT\技术\sylar\sylar\module.h", "C++", 92, 0, 10, 27, 129
"d:\RECENT\技术\sylar\sylar\mutex.cc", "C++", 62, 0, 0, 12, 74
"d:\RECENT\技术\sylar\sylar\mutex.h", "C++", 214, 0, 178, 60, 452
"d:\RECENT\技术\sylar\sylar\noncopyable.h", "C++", 12, 0, 23, 8, 43
"d:\RECENT\技术\sylar\sylar\ns\name_server_module.cc", "C++", 345, 0, 30, 36, 411
"d:\RECENT\技术\sylar\sylar\ns\name_server_module.h", "C++", 53, 0, 2, 14, 69
"d:\RECENT\技术\sylar\sylar\ns\ns_client.cc", "C++", 169, 0, 0, 26, 195
"d:\RECENT\技术\sylar\sylar\ns\ns_client.h", "C++", 36, 0, 0, 12, 48
"d:\RECENT\技术\sylar\sylar\ns\ns_protocol.cc", "C++", 197, 0, 0, 32, 229
"d:\RECENT\技术\sylar\sylar\ns\ns_protocol.h", "C++", 97, 0, 7, 26, 130
"d:\RECENT\技术\sylar\sylar\orm\column.cc", "C++", 238, 0, 1, 27, 266
"d:\RECENT\技术\sylar\sylar\orm\column.h", "C++", 65, 0, 0, 15, 80
"d:\RECENT\技术\sylar\sylar\orm\index.cc", "C++", 57, 0, 0, 11, 68
"d:\RECENT\技术\sylar\sylar\orm\index.h", "C++", 36, 0, 0, 9, 45
"d:\RECENT\技术\sylar\sylar\orm\orm.cc", "C++", 62, 0, 0, 7, 69
"d:\RECENT\技术\sylar\sylar\orm\table.cc", "C++", 963, 0, 7, 83, 1053
"d:\RECENT\技术\sylar\sylar\orm\table.h", "C++", 50, 0, 0, 13, 63
"d:\RECENT\技术\sylar\sylar\orm\util.cc", "C++", 39, 0, 0, 10, 49
"d:\RECENT\技术\sylar\sylar\orm\util.h", "C++", 16, 0, 0, 6, 22
"d:\RECENT\技术\sylar\sylar\protocol.cc", "C++", 59, 0, 0, 13, 72
"d:\RECENT\技术\sylar\sylar\protocol.h", "C++", 76, 0, 8, 23, 107
"d:\RECENT\技术\sylar\sylar\rock\rock_protocol.cc", "C++", 245, 0, 0, 34, 279
"d:\RECENT\技术\sylar\sylar\rock\rock_protocol.h", "C++", 79, 0, 0, 23, 102
"d:\RECENT\技术\sylar\sylar\rock\rock_server.cc", "C++", 62, 0, 2, 6, 70
"d:\RECENT\技术\sylar\sylar\rock\rock_server.h", "C++", 17, 0, 0, 7, 24
"d:\RECENT\技术\sylar\sylar\rock\rock_stream.cc", "C++", 212, 0, 7, 28, 247
"d:\RECENT\技术\sylar\sylar\rock\rock_stream.h", "C++", 94, 0, 0, 25, 119
"d:\RECENT\技术\sylar\sylar\scheduler.cc", "C++", 233, 0, 17, 41, 291
"d:\RECENT\技术\sylar\sylar\scheduler.h", "C++", 116, 0, 114, 29, 259
"d:\RECENT\技术\sylar\sylar\singleton.h", "C++", 34, 0, 28, 12, 74
"d:\RECENT\技术\sylar\sylar\socket.cc", "C++", 577, 0, 3, 79, 659
"d:\RECENT\技术\sylar\sylar\socket.h", "C++", 122, 0, 252, 62, 436
"d:\RECENT\技术\sylar\sylar\stream.cc", "C++", 51, 0, 0, 8, 59
"d:\RECENT\技术\sylar\sylar\stream.h", "C++", 21, 0, 89, 15, 125
"d:\RECENT\技术\sylar\sylar\streams\async_socket_stream.cc", "C++", 272, 0, 2, 39, 313
"d:\RECENT\技术\sylar\sylar\streams\async_socket_stream.h", "C++", 144, 0, 0, 31, 175
"d:\RECENT\技术\sylar\sylar\streams\load_balance.cc", "C++", 386, 0, 68, 53, 507
"d:\RECENT\技术\sylar\sylar\streams\load_balance.h", "C++", 168, 0, 18, 42, 228
"d:\RECENT\技术\sylar\sylar\streams\service_discovery.cc", "C++", 318, 0, 10, 42, 370
"d:\RECENT\技术\sylar\sylar\streams\service_discovery.h", "C++", 88, 0, 3, 18, 109
"d:\RECENT\技术\sylar\sylar\streams\socket_stream.cc", "C++", 83, 0, 0, 15, 98
"d:\RECENT\技术\sylar\sylar\streams\socket_stream.h", "C++", 29, 0, 67, 16, 112
"d:\RECENT\技术\sylar\sylar\streams\zlib_stream.cc", "C++", 182, 0, 0, 35, 217
"d:\RECENT\技术\sylar\sylar\streams\zlib_stream.h", "C++", 66, 0, 0, 17, 83
"d:\RECENT\技术\sylar\sylar\sylar.h", "C++", 64, 0, 8, 10, 82
"d:\RECENT\技术\sylar\sylar\tcp_server.cc", "C++", 130, 0, 0, 18, 148
"d:\RECENT\技术\sylar\sylar\tcp_server.h", "C++", 139, 0, 65, 31, 235
"d:\RECENT\技术\sylar\sylar\thread.cc", "C++", 65, 0, 0, 15, 80
"d:\RECENT\技术\sylar\sylar\thread.h", "C++", 26, 0, 47, 15, 88
"d:\RECENT\技术\sylar\sylar\timer.cc", "C++", 178, 0, 0, 25, 203
"d:\RECENT\技术\sylar\sylar\timer.h", "C++", 57, 0, 93, 19, 169
"d:\RECENT\技术\sylar\sylar\uri.h", "C++", 42, 0, 96, 27, 165
"d:\RECENT\技术\sylar\sylar\util.cc", "C++", 782, 0, 5, 85, 872
"d:\RECENT\技术\sylar\sylar\util.h", "C++", 357, 0, 35, 76, 468
"d:\RECENT\技术\sylar\sylar\util\crypto_util.cc", "C++", 237, 0, 11, 34, 282
"d:\RECENT\技术\sylar\sylar\util\crypto_util.h", "C++", 69, 0, 14, 20, 103
"d:\RECENT\技术\sylar\sylar\util\hash_util.cc", "C++", 489, 0, 5, 67, 561
"d:\RECENT\技术\sylar\sylar\util\hash_util.h", "C++", 41, 0, 5, 12, 58
"d:\RECENT\技术\sylar\sylar\util\json_util.cc", "C++", 164, 0, 0, 15, 179
"d:\RECENT\技术\sylar\sylar\util\json_util.h", "C++", 33, 0, 0, 6, 39
"d:\RECENT\技术\sylar\sylar\worker.cc", "C++", 98, 0, 0, 19, 117
"d:\RECENT\技术\sylar\sylar\worker.h", "C++", 66, 0, 0, 15, 81
"d:\RECENT\技术\sylar\sylar\zk_client.cc", "C++", 116, 0, 6, 24, 146
"d:\RECENT\技术\sylar\sylar\zk_client.h", "C++", 71, 0, 0, 13, 84
"Total", "-", 31180, 9808, 7689, 6485, 55162